11111111111111111111111111111111111111111111111111111
1000C0000C1100000C0000C1100100C00C11000C000C00100C001
10011110000000111100000000111000000011110000000011001
10001111100000001111000000110000000110110000000011001
10000111100000011110000001110000001111000000000011001
10000111110000000011110000001111100000011110000011001
1000011111000C0001111000C00000000C000111000C000011001
10000111100000001111000000111100000011110000000011111
100001111000000011110000000001100C00011110000000111C1
10000111100000000111110000011110000000111000000011101
10000111000000011110000000011110000000111000000011001
1P0000E000001100100C00C1100100C00C000C0000C000000C0C1
11111111110111111111111111111111111111111111101111111
11111111110111111111111000111111111111111111101111111
11111111110111111110000101111111111111111111101111111
11111111110111111000110000000111111111111111101111111
11111111110000C00011000101110111111111111111101111111
11111111110111111111111111110111111111111111101111111
11111111110111111111111110000000000000000000001111111
11111111110000000000000000000000000000000000001111111
11111111110111111111111110000000000000000000001111111
11111111110000000000000000000000000000000000001111111
11111111110111111111111110000000000000000000001111111
11111111110000000000000000000000000000000000001111111
11111111110000000000000000000000000000000000001111111
11111111110111111111111110000000000000000000001111111
11111111110000000000000000000000000000000000001111111
11111111110000000000000000000000000000000000001111111
11111111111111111111111111111111111111111111111111111