111111111111111111111111111111111111111111111111111111111111
1000C0000C1100000C0000C1100100C00C11000C000C00100C0011111111
100111100000001111000000001110000000111100000000110011111111
100011111000000011110000001100000001101100000000110011111111
100001111000000111100000011100000011110000000000110011111111
100001111100000000111100000011111000000111100000110011111111
1000011111000C0001111000C00000000C000111000C0000110011111111
100001111000000011110000001111000000111100000000111111111111
100001111000000011110000000001100C00011110000000111C11111111
100001111000000001111100000111100000001110000000111011111111
100001110000000111100000000111100000001110000000110011111111
1P0011E000001100100C00C1100100C00C000C0000C000000C0C11111111
111111111101111111111111111111111111111111111011111111111111
111111111101111111111110001111111111111111111011111111111111
111111111101111111100001011111111111111111111011111111111111
111111111101111110001100000001111111111111111011111111111111
11111111110111C000110001011101111111111111111011111111111111
111111111101111111111111111101111111111111111011111111111111
111111111101111111111111100000000000000000000011111111111111
111111111111111111111111111111111111111111111111111111111111