1111111111111
1001000000001
10P0011111001
100011E000011
1111111111111