1111111111111
1001000C00001
10P0011111001
1E00110C10011
1111111111111