1111111111111
100100C0000C1
1000011111001
100011E000011
1111111111111