1111111111111
1001000C00001
10P0011111001
1P00110000011
1111111111111