11111111111111
100100C0000C11
10000111110011
1P0011E0010011
11111111111101
11111111111111