11111111111111
10010000000C11
10000111110011
1P00110E000011
11111111111111