11111111111111
10010000000C11
100P0111110011
1000110E000011
11111111111111