11111111111111111111111111
100100C0000C1100100C0000C1
10000111110000000000000001
10000111110000000000000001
10000111110000000000000001
10000111110000000000000001
10000111110000000000000001
10000111110000000000000001
1P0011E000001100100C0000C1
11111111111111111111111111