11111111111111
10010000000C11
1T0P0111110T11
1000110E000011
11111111111111